1111111111111111111111111111111111111111111111111111
10010000000C00100C0000C00110010000000C00100C0000C001
1000011111000000111110010110000111110000001111100101
10011C00000001100000010011C0011E00000001100000001001
10010000000C00100C0000C001P0010000000C00100C0000C001
1001000C000C00100C0000C0000001000C000C00100C0000C001
10010C00000000100C0000C00110010C00000000100C0000C001
10010C00000000100C0000C00110010C00000000100C0000C001
10010C00000000100C0000C00110010C00000000100C0000C001
1111111111111111111111111111111111111111111111111111